################################
#        #           #         #
#  #     #   #####/###  ###### #
#  ##    #   ##      #  #    # #
#  ###   #   ####   ##  #      #
#  ####      ##      /         #
#  #####  #####  ########/######
#  #   #  #      ####  #  ######
#         ####   ####          #
##/###########   ###########/###
#            #   #       #     #
#  ## # ###  /   #####   #     #
#            #       #   #     #
## ###   ##  #  ###  /         #
################################