###################################
#   # ##                          #
# #    # ############## ######### #
# ###### #   # #      # ## ##   # #
#          # # ###### # #     # # #
###### # ### #      # # ## ##   # #
##   # # # # #### # #   ##### # # #
#  #   # #      # ## ###### #   # #
######## # ####         #   # # # #
#   #    #      ####### # # #   # #
# ### ####/######       # #   #   #
#          #      ####### #########
############/######   # # #   #   #
#                   #   #   #   # #
###################################