################################
#                              #
#  #######   #######    ###### #
#  #     #   #     #    #    # #
#  ###/###   ###/###    ##/### #
#                              #
#                              #
########               #########
#      #               #   #   #
#      #               #   #   #
###/####               /       #
#      #               #    ####
#      #               #       #
###/####               #########
#                              #
#                              #
#        ##/##   ##/##    ###/##
#        #   #   #   #    #    #
################################