#######
#   # #
#   ###
#     #
#######