############################
#    #  #   #      /       # 
#  #    #   #  #   #    #  #
####/####   #  #   #   ##  #
#              #   #   #   #
################   ##/###/##
#                  #   #   #
#                  #    #  #
####/####/####/#####   #   #
#     #    #    ####       #
############################