############################
#   /     #   #    #  #    #
########    #    #    #    #
#   /     #    #   #  /    #
####################  ######
#     /               #    #
#     #   #########   #  ###
#/#####   /      ##   #  ###
#         #########        #
############################