################################
#                              #
#  #######   #######    ###### #
#  #     #   ##    #    #    # #
#  ###  ##   ##/####    ###  # #
#                              #
##/#####  #####  ########/######
#   #  #  #         #          #
#   #  #  #         #  ######  #
#      #  #            #    #  #
########/##         #  #    #  #
#  #  #   #         #  #/####  #
#         ####   ####          #
########/##  #   #  ############
#            #   #       #     #
#  ##   ###  /   #####   #     #
#            #           #     #
######   ##  #   #             #
################################