############################
#  .   #     #        /    #
#  #/#####  ### ##    ######
#  #    ##    #  #  #      #
#  #######    # ##  #### # #
#                #     # # #
########  ########     # # #
#   ## /  #  #   #  ####   #
#   #  #  #  #   #     #####
#      #  /    # #     /   #
########/#########    ######
#     #                  # #
#     #   #########   #    #
#/#####   #           # ####
#           ######         #
############################