################
#      #   /   #
#  ######  #####
#  /   ##      #
#  ######  #####
#          /   #
################